g - ㄱ
k - ㅋ
r - ㄹ
b - ㅂ
s - ㅅ
t - ㅌ 
j - ㅈ
n - ㄴ
d - ㄷ
ch - ㅊ
m - ㅁ
ng - ㅇ
p - ㅍ
h - ㅎ
a - ㅏ
e - ㅔ
i - ㅣ
o - ㅗ
u - ㅜ
ae - ㅐ
eo - ㅓ
eu - ㅡ
ya - ㅑ
ye - ㅖ
yae - ㅒ
yo - ㅛ
yu - ㅠ
bb - ㅃ
gg - ㄲ
ss - ㅆ
